1111111111111
1P01000001001
101000C000001
10C0001000001
1000000000001
100C000010C01
11111110000E1
1111111111111