1111111111111
100C0000010E1
1000000000001
10C0000001001
1C00000000001
1001000000C01
1P00000000001
1111111111111