11111111
1P0001C1
10000001
1C001001
100C0001
111110E1
11111111
