1111111111111
1P0N01C001001
1N00100N000C1
1N11111111N11
1C0C000100C01
1111100NC00E1
1111111111111
