1111111111111
1P0001C0010C1
1000000000001
1C00100001001
100C000100C01
11111000C00E1
1111111111111
