1111111111111
1P0N01C0010C1
110C000N00001
1CN01CN001001
100C000100C01
1111100NC0NE1
1111111111111
